1111111111111111111111
111000100C000000000001
1000011110000000100001
1101000000111111111111
1E0P111100000000000001
1111111111111111111111