1111111111111111111
100000C0000000000E1
1000XXXXXXX0X00P001
10C0X0000000X000001
1000X0XXX000X000001
1000X0X0X000X000001
1000X0X0X0XXXXXX001
1000X0X0X000000X001
1000XC00XXXXXX0XXX1
1000XXXX0000000X001
1000000000000000001
1111111111111111111